
NO ./textures/walls/north_wall.xpm
SO ./textures/walls/south_wall.xpm
WE ./textures/walls/west_wall.xpm
EA ./textures/walls/east_wall.xpm
F 255,204,153
C 102,178,250

        1111111111111111111111111
        1000000000110000000000001
        1011000001110000000000001
        1001000000000000000000001
111111111011000001110000000000001
100000000011000001110111111111111
11110111111111000000000010001
11110111111111011101010010001
11000000110101011100000010001
100000000S0000000000000010001
10000000000000001101010010001
110000011101010111110111100111
11110111 1110101 101111010001
11111111 1111111 111111111111
