NO ./textures/walls/north_wall.xpm
SO ./textures/walls/south_wall.xpm
WE ./textures/walls/west_wall.xpm
EA ./textures/walls/east_wall.xpm

F 255,204,153
C 102,178,250

1111111111111111111111111
10000W0000111000000000001
1001000000000000000000001
1111111110110000011100001
1000000000110000011000001
1111011100011100000010001
1111011100011101010010001
1100000011010101110000001
1000000000000000110000001
1000000000000000110101001
1100000111010101111101111
1111011111101011000001111
1111111111111111111111111